   SO         ./textures/wood.xpm    
  R       4333333333333430         6434343400                 

      NO  ./textures/eagle.xpm


WE          ./textures/greystone.xpm      
      
   EA                ./textures/redbrick.xpm

S     ./textures/barrel.xpm      

F 184,    113,   39     

       C 30   ,138     ,207    





   1
  111
  1201
  101
1110111
100S001
1000001
1100011      111
1000001111111101111111111111111111111111
1000000000000000000000020002000200001010111
1000001000000000000000000000000000000211
100000111111110111111111111111111111111
1110111      101
  101        101
  101        101
  101        101
  101        101
  1011111111110111111111
111000000000200020000001111
1200000000000000000000000001
100000000000000000000000000111111
100000011111000000001111000000001
10000001   1000000001  100000011
100000011111000000001111000011
1000000000000000000000000001
1111100000000000000000011111
   111101111111011111111111
       1       1
               1
