R 918 468
NO ./textures/redbrick.xpm
SO ./textures/eagle.xpm

WE ./textures/wood.xpm
EA ./textures/greystone.xpm

S ./textures/barrel.xpm





F 112,112,112

C 166,56,106



        11111111111111111 1111111
        10000000001111111 1000001
        1001000000101     1100001
        1001011110001111111100001
11111111101101  11110000000000001
11111111101111  11111000111111111
        101         10011
        101    1111110111
11111111101    1000000011
100000000N1    1111111111
11011111121
 1011   111
 1011
 1011
 1111
